[
[[
addgroup - add group to system
adduser - add user to system
ar - create, modify and extract from archives
arp - manipulate the system ARP cache (cache of Address Resolution Protocol entries created when an IP is resolved to a MAC address)
arping - send ARP REQUEST to a neighbor host
ash - shell
awk - pattern scanning and processing language
basename - strip directory and suffix from filename
blkid - locate/print block device attributes
bunzip2 - unzip block-sorted file compressions
bzcat - decompress files to stdout
cat - concatenate files and print to stdout
catv - display nonprinting characters as ^x or M-x
chattr - change file attributes
chgrp - change group ownership
chmod - change file mode bits
chown - change file owner and group
chroot - execute commands or shells with a special root directory
chrt - manipulate the real-time attributes of a process
chvt - change foreground virtual terminal
cksum - checksum and count the bytes in a file
clear - clear the terminal screen
cmp - compare two files byte by byte
cp - copy files and directories
cpio - copy files to and from archives
crond - daemon to execute scheduled commands
crontab - maintains crontab files for individual users
cut - remove sections from each line of files
date - print or set the system date and time
dc - an arbitrary precision calculator
dd - convert and copy a file
deallocvt - deallocate unused virtual consoles
delgroup - remove a group from the system
deluser - remove a user from the system
devmem(2) - read/write from/to any location in memory
df - report file system disk space usage
diff - compare files line by line
dirname - strip last component from file name
dmesg - print or control the kernel ring buffer
dnsd - small static DNS server daemon
dnsdomainname - show the system's DNS domain name
dos2unix - DOS/Mac to Unix and vice versa text file format converter
du - estimate file space usage
dumpkmap - print a binary keyboard translation table to stdout
echo - display a line of text
egrep - print lines matching an extended regular expression pattern
eject - eject removable media
env - run a program in a modified environment
ether-wake - send a magic packet to wake up sleeping machines
expr - evaluate expressions
false - do nothing, unsuccessfully
fbset - show and modify frame buffer device settings
fdflush - force floppy disk drive to detect disk change
fdformat - low-level format a floppy disk
fdisk - manipulate disk partition table
fgrep - print lines matching a list of fixed strings seperated by newlines
find - search for files in a directory hierarchy
flock - manage locks from shell scripts
fold - wrap each input line to fit in specified width
free - display amount of free and used memory in the system
freeramdisk - frees the memory used by the loadlin ramdisk
fsck - check and repair a Linux filesystem
fstrim - discard unused blocks on a mounted filesystem
fuser - identify processes using files or sockets
getopt - parse command options
getty - sets the terminal mode, speed and line discipline
grep - print lines matching a regular expression
gunzip - expand gzip files
gzip - compress files in gzip format
halt - halt the machine
hdparm - get/set SATA/IDE device params
head - output the first part of files
hexdump - ASCII, decimal, hexadecimal, octal dump
hostid - print the numeric identifier for the current host
hostname - show or set the system's hostname
hwclock - query or set the hardware clock (RTC)
i2cdetect - detect I2C chips
i2cdump - examine I2C registers
i2cget - read from I2C/SMBus chip registers
i2cset - set I2C registers
id - print real and effective user and group IDs
ifconfig - configure a network interface
ifdown - take a network interface down
ifup - bring a network interface up
inetd - internet super-server
init - service management
insmod - insert modules into the Linux kernel
install - copy files and set attributes
ip - show/manipulate routing, devices, policy routing and tunnels
ipaddr - manipulate IP addresses
ipcrm - remove certain IPC resources
ipcs - show information on IPC facilities
iplink - show and manipulate interface devices
iproute - show and manipulate IP routes
iprule - show and manipulate IP rules
iptunnel - show and manipulate IP tunnels
kill - send a signal to a process
killall - kill processes by name
killall5 - send a signal to all processes
klogd - kernel logger
last - show a listing of last logged in users
less - oposite of more
linux32 - ?
linux64 - ?
linuxrc - ?
ln - make links between files
loadfont - load a console font from stdin
loadkmap - load a binary keyboard translation table from stdin
logger - enter messages into the system log
login - begin session on the system
logname - print user's login name
losetup - set up and control loop devices
ls - list directory content
lsattr - list file attributes
lsmod - show the status of modules in the Linux kernel
lsof - list open files
lspci - list all PCI devices
lsusb - list USB devices
lzcat - list contents of an LZMA compressed file
lzma - compress in LZMA format
makedevs - create a range of special files as specified in a device table
md5sum - compute and check MD5 message digest
mdev - can be ran by kernel as a hotplug helper
mesg - permit or deny messages
microcom - a minimalistic terminal program
mkdir - make directories
mkfifo - make FIFOs
mknod - make block or character special files
mkpasswd - overfeatured front end to crypt (password and data encryption)
mkswap - set up a Linux swap area
mktemp - create a temporary file or directory
modprobe - add and remove modules from the Linux kernel
more - file perusal filter for crt viewing
mount - mount a filesystem
mountpoint - see if a directory or file is a mountpoint
mt - control magnetic tape drive operation
mv - move files
nameif - name network interfaces based on MAC addresses
netstat - print network connections, routing tables, interface statistics, masquerade connections and multicast memberships
nice - run a program with modified scheduling priority
nohup - run a command immune to hangups with output to a non-tty
nslookup - query internet name servers interactively
od - dump files in octal and other formats
openvt - start a program on a new virtual terminal
passwd - change user password
patch - apply a diff file to an original
pidof - find processes by name and list their PIDs
ping - send ICMP ECHO_REQUEST packets to network hosts
pipe_progress - ?
pivot_root - switch root file systems
poweroff - power off the system
printenv - print all or part of environment
printf - format and print data
ps - report a snapshot of the current processes
pwd - print current/working directory
rdate - set the system's date from a remote host
readlink - print resolved symbolic links or canonical file names
readprofile - read kernel profiling information
realpath - print the resolved path
reboot - reboot the system
renice - alter priority of a running process
reset - terminal initialization
resize - set environment and terminal settings to current xterm window size
rm - remove files or directories
rmdir - remove empty directories
rmmod - remove a module from the Linux kernel
route - show/manipulate the IP routing table
run-parts - run scripts or programs in a directory
runlevel - print previous and current SysV runlevel
sed - stream editor for filtering and transforming text
seq - print a sequence of numbers
setarch - change reported architecture in new program environment and set personality flags
setconsole - redirect system console output
setkeycodes - load kernel scancode-to-keycode mapping table entries
setlogcons - send kernel messages to console N
setserial - get/set Linux serial port information
setsid - run a program in a new session
sh - shell
sha1sum - compute and check SHA1 message digest
sha256sum - compute and check SHA256 message digest
sha3sum - print or check SHA-3 checksums
sha512sum - compute and check SHA512 message digest
sleep - delay for a specified amount of time
sort - sort lines of text files
start-stop-daemon - start and stop system daemon programs
strings - print the strings of printable characters in files
stty - change and print terminal line settings
su - become superuser
sulogin - single-user login
swapoff - disable devices and files for paging and swapping
swapon - enable devices and files for paging and swapping
switch_root - switch to another filesystem as the root of the mount tree
sync - synchronize cached writes to persistent storage
sysctl - configure kernel parameters at runtime
syslogd - log systems messages
tail - output the last part of files
tar - an archiving utility
tee - read from standard input and write to standard output and files
telnet - user interface to the TELNET protocol
test - check file types and compare values
tftp - trivial file transfer program
time - run programs and summarize system resource usage
top - display Linux processes
touch - change file timestamps
tr - translate or delete characters
traceroute - print the route packets trace to network host
true - do nothing, successfully
truncate - shrink or extend the size of a file to the specified size
tty - print the file name of the terminal connected to stdin
ubirename - ?
udhcpc - DHCP client
uevent - user events
umount - unmount file systems
uname - print system information
uniq - report or omit repeated lines
unix2dos - Unix to DOS/Mac text file format converter
unlink - call the unlink function to remove the specified file
unlzma - uncompress LZMA file
unxz - decompress xz files
unzip - list, test and extract ZIP files
uptime - tell how long the system has been running
usleep - suspend execution for an interval
uudecode - decode an encoded file
uuencode - encode a file into email friendly text
vconfig - VLAN (802.1q) configuration program
vi - text editor
vlock - virtual console lock program
watch - execute a program periodically, showing output fullscreen
watchdog - a software watchdog daemon
wc - print newline, word and byte counts for each file
wget - the non-interactive network downloader
which - locate a command
who - show who is logged on
whoami - print effective userid
xargs - build and execute command lines from standard input
xz - compress .xz files
xzcat - show contents of .xz files
yes - output a string repeatedly until killed
zcat - show contents of gzip file
